30 30 30 30 30 30 30 30 30 30 30 30 30 30 30 30 30 30 30 30
30 31 31 31 31 31 31 31 31 31 31 31 31 31 31 31 31 31 31 30
30 31 31 31 31 31 31 31 31 31 31 31 31 31 31 31 31 31 31 30
30 31 31 31 31 31 31 31 31 31 31 31 31 31 31 31 31 31 31 30
30 31 31 27 31 31 31 31 31 31 31 31 31 31 31 31 31 31 31 30
30 31 31 31 31 31 31 31 31 31 31 31 31 31 31 31 31 31 31 30
30 31 31 31 31 31 31 31 31 31 31 31 31 31 31 31 31 31 31 30
30 31 31 31 31 31 31 31 31 31 31 31 31 31 31 31 31 31 31 30
30 31 31 31 31 31 31 31 31 31 31 31 31 31 31 31 31 31 31 30
30 31 31 31 31 31 31 31 31 31 31 31 31 31 31 31 31 31 31 30
30 31 31 31 31 31 31 31 31 31 31 31 31 31 31 31 31 31 31 30
30 30 30 30 30 30 30 30 30 30 30 30 30 30 30 30 30 30 30 30